{
  "rows" : 23,
  "cols" : 23,
  "board" : [
    [ "~", "~", "~", "~", "~", "~", "~", "~", "~", "~", "~", "~", "~", "~", "~", "~", "~", "~", "~", "~", "~", "~", "~" ]
  , [ "~", "~", "~", "~", "~", "~", "~", "~", "~", "~", "~", "~", "~", "~", "~", "~", "~", "~", "~", "~", "~", "~", "~" ]
  , [ "~", "~", "~", "~", "~", "~", "~", "~", "~", "~", "~", "~", "~", "~", "~", "~", "~", "~", "~", "~", "~", "~", "~" ]
  , [ "~", "~", "~", "~", "~", "~", "~", "~", "~", "~", "~", "~", "~", "~", "~", "~", "~", "~", "~", "~", "~", "~", "~" ]
  , [ "~", "~", "~", "~", "W", "W", "W", "W", "W", "W", "W", "W", "W", "W", "W", "W", "W", "W", "W", "~", "~", "~", "~" ]
  , [ "~", "~", "~", "~", "W", "F", "F", "F", "F", "F", "F", "F", "F", "F", "F", "F", "F", "F", "W", "~", "~", "~", "~" ]
  , [ "~", "~", "~", "~", "W", "F", "F", "F", "F", "F", "F", "F", "F", "F", "F", "F", "F", "F", "W", "~", "~", "~", "~" ]
  , [ "~", "~", "~", "~", "W", "F", "F", "F", "F", "W", "F", "F", "F", "W", "F", "F", "F", "F", "W", "~", "~", "~", "~" ]
  , [ "~", "~", "~", "~", "W", "F", "F", "F:Treasure", "F", "W", "F", "F", "F", "W", "F", "F:Key-PURPLE", "F", "F", "W", "~", "~", "~", "~" ]
  , [ "~", "~", "~", "~", "W", "W", "W", "W", "W", "W", "F", "F", "F", "W", "W", "W", "W", "W", "W", "~", "~", "~", "~" ]
  , [ "~", "~", "~", "~", "W", "F", "F", "F", "W", "F", "F", "I", "F", "F", "W", "F", "F", "F", "W", "~", "~", "~", "~" ]
  , [ "~", "~", "~", "~", "W", "F", "F", "F", "F:Door-PURPLE", "F", "F", "F", "F", "F", "F:Door-ORANGE", "F", "F", "F", "W", "~", "~", "~", "~" ]
  , [ "~", "~", "~", "~", "W", "F", "F", "F", "W", "F", "F", "F", "F", "F", "W", "F", "F", "F", "W", "~", "~", "~", "~" ]
  , [ "~", "~", "~", "~", "W", "F", "F", "F", "W", "W", "F", "F", "F", "W", "W", "F", "F", "F", "W", "~", "~", "~", "~" ]
  , [ "~", "~", "~", "~", "W", "F", "F", "F", "W", "F", "F", "F", "F", "F:Treasure", "W", "F", "F", "F", "W", "~", "~", "~", "~" ]
  , [ "~", "~", "~", "~", "W", "F:Key-ORANGE", "F", "F", "W", "F", "F", "F", "F", "F", "W", "F", "F", "F", "W", "~", "~", "~", "~" ]
  , [ "~", "~", "~", "~", "W", "F", "F", "F", "W", "F", "W", "F:ExitLock", "W", "F", "W", "F", "F", "F", "W", "~", "~", "~", "~" ]
  , [ "~", "~", "~", "~", "W", "F", "F", "F:Treasure", "W", "F", "W", "E", "W", "F", "W", "F", "F", "F:Treasure", "W", "~", "~", "~", "~" ]
  , [ "~", "~", "~", "~", "W", "W", "W", "W", "W", "W", "W", "W", "W", "W", "W", "W", "W", "W", "W", "~", "~", "~", "~" ]
  , [ "~", "~", "~", "~", "~", "~", "~", "~", "~", "~", "~", "~", "~", "~", "~", "~", "~", "~", "~", "~", "~", "~", "~" ]
  , [ "~", "~", "~", "~", "~", "~", "~", "~", "~", "~", "~", "~", "~", "~", "~", "~", "~", "~", "~", "~", "~", "~", "~" ]
  , [ "~", "~", "~", "~", "~", "~", "~", "~", "~", "~", "~", "~", "~", "~", "~", "~", "~", "~", "~", "~", "~", "~", "~" ]
  , [ "~", "~", "~", "~", "~", "~", "~", "~", "~", "~", "~", "~", "~", "~", "~", "~", "~", "~", "~", "~", "~", "~", "~" ]
  ],
  "time" : 60,
  "levelInfo" : {
    "levelNumber" : 1,
    "maxKeys" : 2,
    "maxTreasures": 4
  },
  "player" : {
    "x" : 11,
    "y" : 11,
    "treasures" : 0,
    "direction" : "DOWN",
    "keyColors" : []
  }
}